1111111
1200001
1001001
1000001
1000001
1000001
1111111